######## ##########
#......###........#
#..@...|.|........#
#......###........#
######## #####|####
             #.#
             #.#
             #.#
             #.#
             #.#
             #.#
             #.#
             #.#
             #.#
             #.#
##############|###############################################
#............................................................#
#............................................................#
#............................................................#
#.............S.........R....................................#
#............................................................#
#............................................................#
#.............S..............................................#
#............................................................#
##############################################################